5
1 2 3 0 0
0 0 0 0 0
0 1 4 0 0
0 0 0 2 0
4 3 0 0 0