6
1 0 0 2 3 0
0 0 0 0 4 0
1 0 0 5 0 0
6 0 0 4 0 0
0 0 0 2 5 0
0 0 0 6 3 0