6
0 1 2 0 0 3
0 4 0 0 5 0
0 0 0 0 0 0
0 0 0 0 3 0
0 0 4 2 6 0
0 0 1 6 0 5