7
0 0 0 0 0 0 0
0 0 0 0 0 1 0
2 1 3 0 0 0 0
0 0 0 0 4 0 5
0 0 0 0 6 0 0
3 0 6 0 0 4 0
2 0 7 0 7 5 0