7
1 2 0 0 0 2 1
0 3 4 5 4 3 0
0 0 0 0 0 0 0
0 0 0 5 0 0 0
0 0 0 0 0 0 0
0 0 0 0 0 0 0
0 0 0 0 0 0 0