7
1 0 2 3 0 0 4
-1 0 -2 0 1 0 0
0 0 0 -1 -1 0 0
0 -1 -1 5 0 0 0
0 0 0 0 0 0 0
-1 5 2 0 3 0 -1
-1 0 0 0 -1 0 4