7
1 0 0 0 0 0 0
0 2 3 0 0 4 0
0 0 0 5 0 0 0
0 0 6 7 0 0 0
0 0 0 0 0 0 0
0 0 0 7 3 0 1
2 5 0 0 6 0 4