7
0 0 0 1 2 0 0
0 0 0 3 4 0 0
0 0 5 6 0 0 0
0 0 0 5 6 0 0
0 0 0 0 3 0 0
0 7 0 7 4 0 0
0 0 0 0 1 2 0