7
0 0 0 1 0 0 0
0 2 3 0 4 5 0
0 0 0 0 0 0 0
3 2 1 0 0 0 0
0 6 0 0 4 0 7
0 5 0 7 0 0 0
0 0 0 0 0 0 6