7
1 0 2 0 0 3 0
4 1 0 4 0 5 0
0 0 0 5 0 0 0
0 0 0 0 2 0 0
6 7 0 0 0 0 0
0 0 0 0 0 6 0
7 3 0 0 0 0 0