9
1 0 2 3 -1 0 0 0 4
0 0 3 0 -1 0 5 0 0
0 0 0 2 -1 0 0 6 0
0 0 0 0 0 0 6 5 0
-1 -1 -1 0 -2 0 -1 -1 -1
0 0 0 0 0 0 0 0 0
0 0 7 8 -1 7 0 0 0
0 0 8 0 9 0 9 0 0
4 0 0 0 0 0 0 0 1