9
0 0 0 0 0 1 0 0 2
0 -1 3 4 -1 2 0 -1 5
0 -1 0 0 5 0 0 0 0
0 -1 0 0 6 0 0 0 0
0 -1 0 0 -1 4 7 -1 0
0 0 3 0 0 0 0 -1 0
6 0 0 8 0 8 0 -1 0
0 -1 0 1 -1 7 0 -1 0
0 0 0 0 0 0 0 0 0