9
0 0 0 0 0 0 0 0 0
0 1 2 0 3 4 5 6 0
0 0 0 0 0 0 0 0 7
0 0 0 0 4 5 0 0 6
0 0 0 0 0 0 0 0 3
0 0 0 0 0 0 0 0 0
0 0 0 0 0 0 0 0 0
0 8 0 0 0 0 8 0 0
0 0 0 7 1 0 0 0 2